252,274,252,274,274,274,274,274,252,252,252,274,274,274,252,274,274,274,274,252,274,274,274,274,274,274,274,274,274,274,274,274,274,274,274,274,274,274,274,274,274,274,274,274,274,274,274,274,274,274
274,274,274,274,274,272,272,272,272,272,272,274,274,274,274,274,272,271,271,274,274,274,274,274,274,264,274,264,264,264,264,245,264,264,264,265,265,264,264,264,264,264,264,264,264,264,264,264,264,274
274,274,274,286,287,287,287,288,274,274,274,274,271,271,274,274,274,274,273,274,274,274,274,274,264,264,274,264,264,264,264,245,264,264,264,264,264,264,267,273,264,264,264,264,264,264,264,264,264,274
252,274,274,308,309,309,309,310,274,274,274,274,274,376,271,274,274,376,274,274,274,274,274,274,264,274,274,274,264,264,264,264,264,264,264,264,264,264,264,274,264,264,264,264,264,264,264,264,264,274
272,274,274,308,309,309,309,310,274,274,274,274,274,274,273,274,274,274,274,274,274,274,274,274,264,274,274,274,264,274,264,264,143,144,145,264,264,183,264,272,264,264,264,264,264,264,264,264,264,274
272,274,274,308,309,309,309,310,309,309,309,309,309,309,309,376,274,274,274,274,274,274,274,274,274,264,274,274,274,264,265,264,165,166,167,264,264,264,264,264,265,264,264,264,264,264,264,264,264,274
274,274,274,308,309,309,309,310,274,274,273,274,274,274,271,309,274,376,272,272,274,274,274,274,274,274,274,274,264,264,245,264,187,188,189,264,264,264,264,264,245,264,264,264,264,264,264,264,264,274
274,274,274,330,331,331,331,332,274,274,274,271,271,376,271,309,274,274,274,274,274,274,274,274,274,274,274,264,264,264,245,264,264,264,264,264,264,264,264,245,245,264,264,264,264,264,264,264,264,274
252,274,274,274,274,274,274,274,274,274,274,274,274,273,274,309,274,274,271,274,274,274,274,274,274,274,274,264,274,264,265,264,264,264,264,264,264,264,264,244,265,265,264,264,264,264,264,264,264,274
274,274,274,274,274,274,274,274,274,274,274,274,274,274,274,309,274,274,274,274,274,274,274,274,274,264,264,274,274,264,264,265,264,264,264,264,264,264,264,264,264,264,264,264,264,264,264,264,264,274
274,286,287,288,274,274,274,274,274,274,274,274,274,274,274,309,274,274,274,274,274,274,274,274,264,264,274,274,264,264,264,245,245,264,264,264,264,264,264,264,264,264,264,264,264,264,264,264,264,274
274,308,309,310,274,271,274,274,376,271,274,270,274,286,287,288,274,274,274,274,274,274,274,274,274,274,274,274,264,264,264,245,154,155,156,264,265,264,264,264,264,264,264,264,264,264,264,264,264,274
274,330,331,332,309,309,309,309,309,309,309,309,309,308,309,310,274,274,270,274,274,274,274,274,274,264,274,274,264,264,264,245,176,177,178,264,264,264,267,273,264,208,264,264,264,264,264,264,264,274
274,274,274,274,274,274,376,270,274,274,274,274,274,330,331,332,274,274,274,274,274,274,274,274,264,264,274,264,264,264,264,264,198,199,200,264,267,267,271,274,264,264,264,264,264,264,264,264,264,274
252,274,274,274,274,271,273,274,376,274,274,274,274,309,271,274,274,271,274,274,274,274,274,274,264,274,274,264,264,264,264,264,245,244,264,264,181,183,274,212,212,264,146,264,264,264,264,264,264,274
274,274,274,274,272,274,271,274,271,274,274,273,274,309,274,274,273,274,274,274,274,274,274,274,264,264,274,264,264,264,265,265,264,245,264,265,203,205,274,271,265,265,168,264,264,208,264,264,264,274
274,271,274,274,274,376,272,274,274,274,274,286,287,288,274,274,271,272,271,274,274,274,274,274,264,264,274,264,264,264,264,245,242,264,264,264,265,244,245,244,245,264,190,264,264,230,230,230,264,274
274,274,271,270,274,274,272,274,274,274,274,308,309,310,274,270,272,272,274,274,274,274,274,274,264,264,264,264,264,264,264,264,264,264,264,264,265,264,243,245,245,264,245,264,264,264,265,264,243,274
252,274,271,273,274,274,274,274,274,274,274,330,331,332,309,309,376,309,309,309,309,274,274,274,264,264,264,264,274,264,264,264,264,264,264,264,264,264,264,264,264,264,264,264,264,209,211,245,244,274
274,274,274,274,274,274,274,274,274,274,274,274,274,274,274,274,274,274,274,274,309,274,274,274,264,274,274,264,274,264,264,265,265,264,264,264,264,264,264,264,264,264,264,264,264,264,264,264,264,274
274,274,274,274,274,274,274,274,274,274,274,274,274,274,274,274,274,274,274,274,309,309,309,264,274,264,264,264,264,264,264,264,264,264,264,264,264,264,264,264,264,264,264,264,264,264,264,264,264,274
274,274,274,274,274,274,274,274,274,274,274,274,274,274,274,274,274,274,274,274,274,274,274,264,264,264,264,264,264,264,264,264,264,264,264,264,264,264,264,264,264,264,264,264,264,264,264,264,264,274
274,110,110,274,274,274,274,274,274,274,110,274,110,110,110,274,274,274,274,274,110,274,274,264,264,264,274,264,264,264,264,264,264,264,264,264,264,264,264,487,264,264,264,264,264,264,264,264,264,274
274,274,110,110,274,274,274,274,110,110,110,274,274,110,110,110,110,274,110,110,274,274,264,264,274,264,264,264,264,264,487,264,264,264,487,487,264,264,264,264,264,264,264,487,264,264,264,264,264,274
274,274,274,110,110,274,110,110,274,274,274,111,274,274,111,110,274,274,111,110,110,274,274,264,274,264,264,487,264,487,487,487,487,264,487,487,487,487,487,487,487,264,264,264,264,487,264,264,264,274
274,110,274,274,110,110,110,274,274,110,110,110,110,110,110,274,274,111,110,110,110,264,110,274,274,487,487,487,487,487,487,487,487,264,487,487,487,487,487,264,487,487,487,487,487,487,487,487,264,274
274,110,110,110,110,110,110,110,110,110,110,110,110,110,110,110,110,110,110,110,110,110,110,110,487,487,487,264,487,487,487,487,487,487,487,487,264,264,487,487,264,487,487,264,487,264,487,487,487,274
274,110,110,110,110,110,110,110,110,110,110,110,110,110,110,110,110,110,110,110,110,110,110,110,110,487,487,487,487,487,487,487,487,487,487,487,487,487,487,487,487,487,487,487,487,487,419,487,487,274
274,110,110,110,110,110,110,110,110,110,110,110,110,110,110,110,110,110,110,110,110,110,110,110,110,110,487,487,487,487,487,487,487,487,487,487,487,487,487,487,487,487,487,487,487,419,419,487,487,274
274,113,110,113,113,110,121,110,110,110,110,110,110,110,113,110,110,110,110,110,110,110,110,110,245,110,487,487,487,487,487,487,487,487,487,487,419,487,487,487,487,487,487,487,510,419,487,487,487,274
274,113,113,113,110,23,113,121,121,121,23,114,110,110,110,110,110,110,110,110,110,110,110,110,487,487,111,487,487,487,487,487,419,419,507,507,507,507,507,487,419,487,487,487,487,487,487,510,487,274
274,23,23,110,110,23,23,114,23,121,121,121,121,113,121,113,110,110,110,110,110,110,110,111,111,487,487,487,487,487,487,487,419,507,507,438,438,419,510,506,487,487,487,487,487,487,419,419,510,274
274,23,23,23,23,23,23,23,23,23,23,23,121,121,121,121,113,113,113,110,110,110,110,487,110,487,110,487,487,487,487,487,487,506,506,506,506,506,506,506,506,506,510,510,510,510,419,419,419,274
274,23,23,23,23,23,23,89,23,23,23,111,121,121,121,121,121,23,23,110,110,110,110,487,110,487,487,110,487,487,487,506,487,487,438,438,438,510,510,508,487,506,487,419,506,506,506,506,419,274
274,23,23,23,23,23,23,23,23,23,23,23,23,121,121,113,121,121,114,110,110,110,110,110,487,487,487,487,487,487,487,506,419,487,487,507,438,510,507,507,507,506,506,506,506,506,506,507,419,274
274,23,23,23,89,23,23,23,23,23,23,23,23,23,23,113,121,113,23,110,110,110,110,110,110,487,487,110,487,487,487,506,419,487,487,507,487,487,507,419,487,506,506,487,487,487,487,507,419,274
274,23,23,23,23,14,23,23,23,23,11,12,13,23,23,113,121,121,110,110,110,487,487,487,487,110,487,487,487,487,487,506,506,507,487,507,438,438,438,438,438,438,438,487,487,487,487,419,419,274
274,23,23,23,89,36,23,23,23,121,33,34,35,23,23,23,113,121,110,110,110,110,487,487,111,487,487,487,487,487,487,507,506,506,487,506,438,438,438,438,438,438,487,487,487,487,487,419,419,274
274,23,23,23,23,58,23,23,23,121,55,56,57,23,23,23,121,121,110,110,110,110,110,487,110,487,487,487,487,487,487,487,506,506,487,506,438,438,419,487,438,438,487,487,487,509,419,419,510,274
274,89,23,23,23,23,23,121,121,121,121,121,121,23,23,23,121,113,110,110,110,110,487,487,110,110,110,110,110,110,487,510,510,507,487,506,438,438,510,510,438,438,487,487,487,509,419,419,419,274
274,23,23,23,23,23,23,121,121,121,121,23,23,23,23,113,121,113,110,110,487,487,487,111,110,487,110,110,487,487,487,487,510,487,487,487,438,438,438,438,438,438,487,487,487,419,419,419,419,274
274,23,23,23,23,23,23,23,23,121,121,121,23,23,23,121,121,110,110,132,487,487,487,487,487,487,110,487,487,487,487,487,507,487,506,487,438,438,438,438,438,438,487,419,419,487,487,487,419,274
274,121,23,121,121,89,89,23,23,77,78,79,23,23,121,113,121,121,110,110,110,110,110,111,487,110,487,487,487,487,487,487,487,487,506,487,510,487,487,487,487,487,419,410,411,412,487,487,419,274
274,121,121,121,121,23,23,23,23,23,23,23,23,23,121,121,121,121,121,110,110,110,110,110,487,110,110,487,487,487,487,487,507,487,506,487,487,487,487,487,487,487,436,432,433,434,437,487,487,274
274,121,121,121,23,23,23,23,23,23,23,23,23,23,23,113,121,23,23,110,110,110,110,110,487,110,487,487,487,487,487,487,507,506,506,487,510,487,487,487,487,487,436,413,414,415,436,487,487,274
274,121,121,121,23,23,23,23,23,23,23,23,23,38,39,113,121,121,23,110,110,110,110,110,110,487,487,487,487,487,487,487,507,506,506,506,478,478,487,487,487,419,436,283,284,285,436,419,419,274
274,23,23,23,23,23,23,121,121,121,121,23,23,60,61,23,113,121,23,46,110,110,110,110,110,110,110,487,487,487,419,487,507,506,506,506,506,419,487,487,487,487,436,283,284,285,436,487,419,274
274,23,23,23,23,89,23,23,23,23,23,23,23,23,23,113,113,121,23,113,110,110,110,111,487,110,487,487,487,487,487,487,487,506,487,506,487,419,487,487,419,510,435,283,284,285,437,487,487,274
274,23,23,23,23,23,23,23,23,23,23,23,23,23,23,23,23,121,113,113,110,110,110,111,487,487,487,487,487,487,487,487,419,506,506,506,487,487,487,419,419,487,487,487,487,487,487,487,419,274
274,274,274,274,274,274,274,274,274,274,274,274,274,274,274,274,274,274,274,274,274,274,274,274,274,274,274,274,274,274,274,274,274,274,274,274,274,274,274,274,274,274,274,274,274,274,274,274,274,274
